0	5	1
5	6	1
6	7	1
7	8	1
8	1	1
1	9	1
9	10	1
10	11	1
11	2	1
2	12	1
12	13	1
13	14	1
14	15	1
15	16	1
16	17	1
17	3	1
3	4	1

